ENTIDAD_RES,MUNICIPIO_RES,Area,Poblacion,Hombres,Mujeres,Densidad de población
2,1,19346,466814,235130,231684,24.12974258
2,2,13700,936826,473203,463623,68.38145985
2,3,3979,101079,53323,47756,25.40311636
2,4,879.2,1559683,783653,776030,1773.979754
2,5,513.32,90668,46301,44367,176.6305618
2,6,32883.93,0,0,0,0
8,1,16918.88,11457,5852,5605,0.677172484
8,2,9232.76,22302,11099,11203,2.415529051
8,3,2176.39,8409,4258,4151,3.863737657
8,4,495.79,10688,6272,4416,21.55751427
8,5,12874.15,23975,12207,11768,1.862258868
8,6,935.34,6011,3074,2937,6.426540082
8,7,5376.1,17672,8980,8692,3.287141236
8,8,2137.93,14362,7297,7065,6.717712928
8,9,2710.11,28766,14147,14619,10.61432931
8,10,7886.63,22378,11287,11091,2.83746036
8,11,13731.6,48748,24032,24716,3.550059716
8,12,2589.47,8795,4403,4392,3.396447922
8,13,3741.65,10587,5380,5207,2.829500354
8,14,1884.56,2284,1184,1100,1.211953984
8,15,11640.77,1681,917,764,0.144406255
8,16,1056.45,3982,2043,1939,3.769227129
8,17,3614.07,154639,75936,78703,42.78804782
8,18,1608.37,5414,2812,2602,3.366140876
8,19,8384.37,819543,399495,420048,97.74652121
8,20,1982.34,8441,4448,3993,4.258099014
8,21,534.93,137935,68013,69922,257.8561681
8,22,1034.34,2911,1478,1433,2.814355048
8,23,1683.97,5892,2941,2951,3.498874683
8,24,672.65,3937,1979,1958,5.852969598
8,25,854,8624,4295,4329,10.09836066
8,26,483.21,3209,1655,1554,6.641004946
8,27,6962.03,49689,24624,25065,7.137142471
8,28,5988.23,6458,3243,3215,1.078448891
8,29,9629.05,53499,27053,26446,5.555999813
8,30,1796.67,8998,4600,4398,5.008153974
8,31,5718.74,39626,19912,19714,6.929148729
8,32,1920.92,107061,51883,55178,55.73423151
8,33,858.09,1049,522,527,1.22248249
8,34,2862.73,6934,3534,3400,2.422163459
8,35,7426.36,10953,5727,5226,1.474881369
8,36,10775.17,41265,20564,20701,3.829637955
8,37,3561.14,1332131,665691,666440,374.0743133
8,38,4123.68,4953,2553,2400,1.201111628
8,39,1312.9,4025,2101,1924,3.065732348
8,40,8763.04,29611,14969,14642,3.379078493
8,41,1012.16,1921,994,927,1.897921277
8,42,5030.6,1601,871,730,0.318252296
8,43,705.82,3104,1578,1526,4.397721799
8,44,1179.19,4499,2293,2206,3.815330863
8,45,429.12,43833,21930,21903,102.1462528
8,46,2173.77,8343,4285,4058,3.838032543
8,47,1805.36,5312,2775,2537,2.942349448
8,48,4880.84,22880,11630,11250,4.687717688
8,49,2004.83,2849,1479,1370,1.42106812
8,50,2647.43,59337,29058,30279,22.41305719
8,51,1810.22,7546,3935,3611,4.168554098
8,52,6796.48,26304,13290,13014,3.870238712
8,53,373.51,4799,2433,2366,12.84838425
8,54,2258.99,8012,4076,3936,3.546717781
8,55,1921.02,16785,8526,8259,8.737545679
8,56,1171.25,2235,1131,1104,1.908217716
8,57,1319.27,2290,1183,1107,1.73580844
8,58,877.18,2983,1549,1434,3.40067033
8,59,479.46,4753,2399,2354,9.913235724
8,60,347.89,10427,5183,5244,29.97211762
8,61,3565.39,3662,1908,1754,1.027096615
8,62,3044.81,32325,16275,16050,10.61642598
8,63,4273.83,6211,3216,2995,1.453263232
8,64,469.68,1869,960,909,3.979305059
8,65,3326.47,20386,10342,10044,6.128418414
8,66,2656.96,8200,4150,4050,3.086233891
8,67,2954.26,5105,2636,2469,1.728013106
5,1,742.99,1070,531,539,1.440127054
5,2,11467.84,136755,68350,68405,11.9250879
5,3,251.55,22675,11114,11561,90.14112502
5,4,1648.96,22544,11540,11004,13.67164758
5,5,2120.04,1808,939,869,0.852814098
5,6,3341.55,25892,12945,12947,7.748499948
5,7,10669.8,13013,6565,6448,1.219610489
5,8,1025.78,2901,1475,1426,2.828091794
5,9,2764.57,55676,27739,27937,20.13911748
5,10,456.22,75215,37561,37654,164.865635
5,11,2641.8,11682,6071,5611,4.42198501
5,12,2927.49,2091,1115,976,0.714263755
5,13,1129.51,1852,955,897,1.639649051
5,14,2200.98,9935,5041,4894,4.513898354
5,15,2458.15,1599,827,772,0.650489189
5,16,673.5,1835,941,894,2.724573125
5,17,806.17,107160,53353,53807,132.9248173
5,18,1251.32,216206,107401,108805,172.7823418
5,19,639.49,8207,4095,4112,12.83366433
5,20,8289.58,66834,33465,33369,8.062410882
5,21,716.68,6335,3186,3149,8.83937043
5,22,908.1,27928,14237,13691,30.75432221
5,23,26053.42,10991,5652,5339,0.421864001
5,24,10523.86,45401,23062,22339,4.31410148
5,25,474.56,152806,76404,76402,321.9951113
5,26,2886.87,3473,1774,1699,1.203033043
5,27,6769.52,75461,38302,37159,11.14717144
5,28,1976.35,60847,30247,30600,30.78756293
5,29,289.62,2314,1175,1139,7.989779711
5,30,5652.98,725123,359366,365757,128.2726986
5,31,6444.62,22149,11044,11105,3.436820169
5,32,803.04,41649,20502,21147,51.86416617
5,33,7174.48,102650,51393,51257,14.30765714
5,34,7920.54,6375,3306,3069,0.804869365
5,35,1255.98,639629,312135,327494,509.2668673
5,36,4409.96,21319,10762,10557,4.834284211
5,37,1855.48,6289,3217,3072,3.389419449
5,38,7939.19,12702,6410,6292,1.599911326
11,1,614.56,84332,40281,44051,137.2233793
11,2,877.43,109030,51803,57227,124.2606248
11,3,1558.96,160383,75878,84505,102.8782009
11,4,375.87,64433,31177,33256,171.4236305
11,5,419.39,85319,41038,44281,203.4359427
11,6,322.27,5610,2748,2862,17.40776368
11,7,553.23,468469,225024,243445,846.7888582
11,8,819.83,37145,17546,19599,45.30817365
11,9,485.39,77794,36430,41364,160.2711222
11,10,123.83,11691,5462,6229,94.41169345
11,11,334.2,88397,42650,45747,264.5032914
11,12,260.22,27308,13071,14237,104.9419722
11,13,230.9,23324,11129,12195,101.0134257
11,14,1656.18,148173,69891,78282,89.46672463
11,15,1014.54,171709,82830,88879,169.2481322
11,16,127.52,20117,9421,10696,157.7556462
11,17,851.41,529440,254784,274656,621.839067
11,18,176.56,36584,17661,18923,207.2043498
11,19,883.4,50832,23555,27277,57.54131764
11,20,1220.38,1436480,701781,734699,1177.075993
11,21,139.02,49364,23282,26082,355.0855992
11,22,1026.04,22683,10870,11813,22.10732525
11,23,1561.25,149936,70551,79385,96.03586869
11,24,60.08,11169,5201,5968,185.9021305
11,25,290.41,68795,33782,35013,236.8892256
11,26,441.26,56655,27274,29381,128.3936908
11,27,756.54,260732,126354,134378,344.6374283
11,28,592.43,97054,45885,51169,163.8235741
11,29,1014.47,37103,17286,19817,36.57377744
11,30,3006.79,106952,51340,55612,35.57015954
11,31,425.98,113570,55026,58544,266.608761
11,32,547.97,72411,34637,37774,132.1440955
11,33,2029.97,115656,54726,60930,56.974241
11,34,194.37,5120,2401,2719,26.34151361
11,35,428.51,79214,37921,41293,184.8591631
11,36,84.13,6670,3111,3559,79.28206347
11,37,538.72,173024,83948,89076,321.1761212
11,38,119.98,11641,5511,6130,97.02450408
11,39,333.99,35571,16975,18596,106.5031887
11,40,410.85,18175,8765,9410,44.23755629
11,41,145.76,59305,28331,30974,406.8674533
11,42,820.66,141058,66846,74212,171.8836059
11,43,1047.06,19820,9365,10455,18.92919221
11,44,128.79,55782,26905,28877,433.1236897
11,45,898.96,11560,5534,6026,12.85930408
11,46,668.4,70782,33438,37344,105.8976661
12,1,1724.64,789971,382276,407695,458.0497959
12,2,870.79,25027,11748,13279,28.74056891
12,3,1967.04,38203,18342,19861,19.42156743
12,4,466.92,18971,8917,10054,40.63008652
12,5,102.66,6637,3114,3523,64.65030197
12,6,626.57,12389,5949,6440,19.7727309
12,7,781.51,32181,15644,16537,41.17797597
12,8,567.39,8390,4015,4375,14.78700717
12,9,141.59,5706,2728,2978,40.29945618
12,10,576.41,26341,12674,13667,45.69837442
12,11,1440.38,61316,30113,31203,42.56932198
12,12,1046.15,62690,30706,31984,59.92448502
12,13,394.79,14429,7102,7327,36.5485448
12,14,234.71,15019,7363,7656,63.98960419
12,15,305.06,12688,6192,6496,41.591818
12,16,2607.04,13025,6632,6393,4.996087517
12,17,445.7,14707,7060,7647,32.99753197
12,18,299.86,13636,6717,6919,45.47455479
12,19,726.64,14456,6860,7596,19.89430805
12,20,306.79,18855,9049,9806,61.45897845
12,21,1809.49,73460,35960,37500,40.59707431
12,22,3403.52,42069,21849,20220,12.3604386
12,23,641.92,25922,12944,12978,40.38197906
12,24,239.8,7007,3344,3663,29.22018349
12,25,310.69,15115,7554,7561,48.64977952
12,26,378.24,9166,4443,4723,24.23329103
12,27,1336.76,21388,10528,10860,15.99988031
12,28,752.67,120790,57940,62850,160.4820174
12,29,2180.94,241717,115443,126274,110.831568
12,30,290.68,20175,9967,10208,69.4062199
12,31,256.83,6301,3042,3259,24.53373827
12,32,1703.76,36586,18348,18238,21.47368174
12,33,286.79,14393,6823,7570,50.18654765
12,34,1325,37364,17935,19429,28.19924528
12,35,569.1,140363,67611,72752,246.6403093
12,36,189.63,10815,5290,5525,57.03211517
12,37,214.38,6603,3148,3455,30.8004478
12,38,1485.15,118211,58314,59897,79.59532707
12,39,409.07,24364,11949,12415,59.5594886
12,40,719.24,24720,12231,12489,34.36961237
12,41,479.85,29599,14110,15489,61.68385954
12,42,624.95,17702,8504,9198,28.32546604
12,43,610.35,18976,9014,9962,31.09035799
12,44,522.17,11376,5617,5759,21.78600839
12,45,705.71,24723,11878,12845,35.03280384
12,46,609.25,61306,29891,31415,100.625359
12,47,294.64,6978,3215,3763,23.68313875
12,48,1987.66,44979,22397,22582,22.62912168
12,49,163.04,11558,5597,5961,70.890579
12,50,132.14,37035,17921,19114,280.2709248
12,51,836.37,34728,16855,17873,41.52229277
12,52,1100,42360,20867,21493,38.50909091
12,53,1158.47,48501,23896,24605,41.86642727
12,54,2387.6,28009,13755,14254,11.73102697
12,55,650.79,104053,50432,53621,159.887214
12,56,697.78,44079,21733,22346,63.17034022
12,57,2787.55,62071,30871,31200,22.26722391
12,58,1009.65,53769,25442,28327,53.2550884
12,59,850.79,30470,14612,15858,35.81377308
12,60,219.49,13128,6356,6772,59.81138093
12,61,382.83,40058,19369,20689,104.6365227
12,62,797.83,21306,10191,11115,26.70493714
12,63,277.61,9967,4734,5233,35.90288534
12,64,462.66,11495,5737,5758,24.84545887
12,65,116.51,7096,3396,3700,60.90464338
12,66,608.1,81419,38983,42436,133.8908074
12,67,281.87,21819,10558,11261,77.40802498
12,68,1748.5,25712,13087,12625,14.70517587
12,69,226.24,12240,5690,6550,54.10183876
12,70,273.92,7079,3289,3790,25.84331192
12,71,464.89,28089,13646,14443,60.42074469
12,72,229.26,10516,5037,5479,45.86931868
12,73,2139.87,18813,9799,9014,8.791655568
12,74,301.36,22587,10750,11837,74.95022564
12,75,1257.38,46158,22634,23524,36.70966613
12,76,631.59,32792,16070,16722,51.91975807
12,77,210.22,12912,6396,6516,61.42136809
12,78,621.53,18778,8945,9833,30.21254002
12,79,133.41,15678,7743,7935,117.5174275
12,80,253.42,7166,3605,3561,28.27716834
12,81,237.09,10522,5075,5447,44.37977139
13,1,241.6,20077,9669,10408,83.10016556
13,2,238.87,40583,19390,21193,169.8957592
13,3,271.86,54299,25741,28558,199.7314794
13,4,120.02,8994,4294,4700,74.93751041
13,5,253.11,17055,8375,8680,67.38177077
13,6,433.52,18879,9208,9671,43.54816387
13,7,272.32,11294,5593,5701,41.47326675
13,8,322.22,42563,20359,22204,132.09298
13,9,137.6,17374,8267,9107,126.2645349
13,10,63.43,26904,13253,13651,424.1526092
13,11,142.65,19452,9370,10082,136.3617245
13,12,457.09,26940,12776,14164,58.93806471
13,13,121.34,31078,15193,15885,256.1232899
13,14,211.01,16962,8195,8767,80.38481589
13,15,593.63,18427,8919,9508,31.04122096
13,16,391.39,54500,25893,28607,139.2472981
13,17,278.33,12271,6044,6227,44.08795315
13,18,232.3,22402,11328,11074,96.43564356
13,19,222.82,17436,8491,8945,78.25150346
13,20,239.54,2800,1321,1479,11.68907072
13,21,123.01,13357,6322,7035,108.5846679
13,22,139.58,13830,6739,7091,99.08296318
13,23,104.99,33901,16202,17699,322.8974188
13,24,302.75,17182,8261,8921,56.75309661
13,25,292.31,22621,10930,11691,77.38702063
13,26,107.46,12779,6295,6484,118.9186674
13,27,214.84,23563,11427,12136,109.6769689
13,28,394.05,122905,60254,62651,311.9020429
13,29,660.71,44253,21176,23077,66.97794797
13,30,486.6,86363,40740,45623,177.4825319
13,31,440.95,12804,6098,6706,29.03730582
13,32,38.39,10933,5416,5517,284.7877051
13,33,110.79,3193,1546,1647,28.82029064
13,34,177.11,9843,4831,5012,55.57563096
13,35,146.34,11429,5339,6090,78.09894766
13,36,245.72,9364,4480,4884,38.10841608
13,37,796.91,21623,10255,11368,27.13355335
13,38,193.82,7980,3875,4105,41.17222165
13,39,53.43,13864,6599,7265,259.4796931
13,40,232.79,10452,5147,5305,44.89883586
13,41,114.79,42834,20483,22351,373.1509713
13,42,198.27,11209,5519,5690,56.53401927
13,43,249.7,6614,3177,3437,26.48778534
13,44,341.32,15666,7689,7977,45.89827728
13,45,79.73,8963,4299,4664,112.4169071
13,46,323.93,39181,19406,19775,120.9551446
13,47,385.15,5049,2354,2695,13.10917824
13,48,154.1,267862,127236,140626,1738.234912
13,49,180.24,18244,9115,9129,101.2205948
13,50,90.98,22217,10536,11681,244.1965267
13,51,115.24,127404,60921,66483,1105.553627
13,52,297.2,32057,15597,16460,107.8633917
13,53,358.48,18137,9006,9131,50.59417541
13,54,205.65,32773,15794,16979,159.3629954
13,55,256.23,16014,7763,8251,62.49853647
13,56,64.29,33495,15938,17557,520.9986001
13,57,420.21,14851,7252,7599,35.34185288
13,58,240.01,16865,7744,9121,70.2679055
13,59,525.06,35067,16658,18409,66.78665295
13,60,176.63,17206,8307,8899,97.41267055
13,61,242.91,51664,24741,26923,212.6878268
13,62,347.34,29125,14788,14337,83.85155755
13,63,353.43,80612,39569,41043,228.0847693
13,64,147.89,9940,4830,5110,67.21211711
13,65,44.93,11112,5465,5647,247.3180503
13,66,90.73,11654,5732,5922,128.4470407
13,67,163.31,48025,23622,24403,294.0726226
13,68,255.46,14037,6853,7184,54.94793705
13,69,76.7,97461,48102,49359,1270.677966
13,70,28.18,17153,8401,8752,608.6941093
13,71,531.6,9753,4821,4932,18.34650113
13,72,82.93,10248,4944,5304,123.5740986
13,73,392.11,36382,17975,18407,92.78518783
13,74,42.31,26758,13076,13682,632.4273221
13,75,117.22,13228,6454,6774,112.8476369
13,76,336.11,103919,50490,53429,309.181518
13,77,217.42,151584,71287,80297,697.1943703
13,78,135.41,19067,9364,9703,140.8093937
13,79,187.07,7320,3618,3702,39.12973753
13,80,154.35,23607,11574,12033,152.9446064
13,81,272.69,32437,15416,17021,118.9519234
13,82,116.95,18036,8678,9358,154.219752
13,83,319.87,39143,19069,20074,122.3715885
13,84,872.24,38516,17948,20568,44.15757131
14,1,339.2,21206,10348,10858,62.51768868
14,2,153.27,23241,12220,11021,151.6343707
14,3,274.09,21714,10677,11037,79.22215331
14,4,125.2,5545,2674,2871,44.28913738
14,5,173.64,14648,7273,7375,84.35844276
14,6,837.81,57340,28013,29327,68.4403385
14,7,194.48,8896,4461,4435,45.7424928
14,8,1150.51,72812,35135,37677,63.28671633
14,9,103.99,17545,8631,8914,168.718146
14,10,355.5,6655,3303,3352,18.72011252
14,11,441.07,5400,2797,2603,12.24295463
14,12,610.8,4115,2014,2101,6.737066143
14,13,510.97,57717,28217,29500,112.9557508
14,14,451.17,8276,3962,4314,18.34341822
14,15,705.94,57559,28210,29349,81.53525795
14,16,431.04,38291,18603,19688,88.83398293
14,17,883.8,12664,6308,6356,14.32903372
14,18,418.21,64269,30920,33349,153.6763827
14,19,866.75,6820,3384,3436,7.868474185
14,20,1540.62,10029,5176,4853,6.509716867
14,21,522.5,21475,10667,10808,41.10047847
14,22,494.91,39020,19694,19326,78.84261785
14,23,274.15,100534,48661,51873,366.7116542
14,24,330.95,26174,12721,13453,79.08747545
14,25,642.58,18091,8711,9380,28.15369293
14,26,265.44,5933,3011,2922,22.35156721
14,27,1394.3,17322,8763,8559,12.42343828
14,28,417.21,2171,1045,1126,5.203614487
14,29,642.53,17795,8488,9307,27.69520489
14,30,613.43,48839,23902,24937,79.61625613
14,31,656.27,3771,1869,1902,5.746110595
14,32,297.82,5814,2896,2918,19.52185884
14,33,425.01,21132,10119,11013,49.72118303
14,34,297.37,2082,1072,1010,7.001378754
14,35,1253.21,51396,24692,26704,41.01148251
14,36,337.99,18632,9157,9475,55.1258913
14,37,117.2,23845,11622,12223,203.4556314
14,38,838.93,4323,2178,2145,5.152992502
14,39,151.42,1495189,717404,777785,9874.448554
14,40,755.88,10284,5501,4783,13.60533418
14,41,308.91,6084,2905,3179,19.69505681
14,42,770.39,8781,4237,4544,11.39812303
14,43,2013.67,23428,11845,11583,11.63447834
14,44,202.39,41060,20419,20641,202.8756361
14,45,831.17,19005,9175,9830,22.86535847
14,46,519.97,31948,15598,16350,61.44200627
14,47,162.78,22881,11337,11544,140.5639513
14,48,665.22,18634,8571,10063,28.01178557
14,49,1475.18,9545,4905,4640,6.470396833
14,50,334.43,42164,20839,21325,126.077206
14,51,138.31,13218,6675,6543,95.56792712
14,52,246.41,5515,2637,2878,22.38139686
14,53,2515.85,153817,74472,79345,61.13917761
14,54,114.29,5499,2752,2747,48.11444571
14,55,293.24,21321,10583,10738,72.70836175
14,56,775,2517,1273,1244,3.247741935
14,57,134.69,3755,1790,1965,27.87883288
14,58,1844.27,14245,7010,7235,7.723923287
14,59,288.85,13225,6288,6937,45.78500952
14,60,287.54,6034,2777,3257,20.98490645
14,61,3360.71,18084,8745,9339,5.381005799
14,62,630.19,3574,1800,1774,5.671305479
14,63,242.46,92967,45453,47514,383.4323187
14,64,1156.18,30097,14636,15461,26.03141379
14,65,875.4,12119,6045,6074,13.84395705
14,66,835.86,48408,23721,24687,57.91400474
14,67,680.41,255681,128577,127104,375.7749004
14,68,1848.7,11623,5933,5690,6.287120679
14,69,676.5,8691,4066,4625,12.84700665
14,70,87.86,138226,69006,69220,1573.252902
14,71,521.49,3176,1583,1593,6.090241424
14,72,352.48,6647,3172,3475,18.85780754
14,73,847.68,65219,32066,33153,76.93823141
14,74,262.09,15454,7296,8158,58.96447785
14,75,305.94,3762,1918,1844,12.29652873
14,76,690.73,3405,1704,1701,4.929567269
14,77,344.16,26306,12785,13521,76.43537889
14,78,787.09,31166,14999,16167,39.59648833
14,79,353.68,14011,6778,7233,39.61490613
14,80,1117.16,5755,3008,2747,5.151455476
14,81,258.98,3726,1758,1968,14.38721137
14,82,215.94,34829,16733,18096,161.2901732
14,83,412.32,69031,34313,34718,167.4209352
14,84,1996.04,14410,7215,7195,7.219294203
14,85,1363.68,37986,18512,19474,27.85550862
14,86,619.48,18096,8848,9248,29.21159682
14,87,1300.59,16847,8220,8627,12.95335194
14,88,79.44,16573,8292,8281,208.62286
14,89,765.77,3511,1722,1789,4.584927589
14,90,281.6,7051,3495,3556,25.0390625
14,91,933.85,40105,18973,21132,42.94586925
14,92,335.57,10837,5307,5530,32.29430521
14,93,1429.7,136123,66244,69879,95.2108834
14,94,1696.23,40697,20148,20549,23.99261893
14,95,219.23,9088,4425,4663,41.45418054
14,96,193.56,20857,10163,10694,107.7547014
14,97,713.95,416626,206958,209668,583.5506688
14,98,110.44,608114,299904,308210,5506.283955
14,99,512.18,9591,4724,4867,18.72583857
14,100,3014.14,35050,17822,17228,11.62852422
14,101,166.1,478689,243241,235448,2881.932571
14,102,293.89,5930,2874,3056,20.17761748
14,103,145.28,7256,3573,3683,49.94493392
14,104,587.44,4435,2209,2226,7.549707204
14,105,337.07,21871,10668,11203,64.88563206
14,106,428.82,4234,2168,2066,9.873606641
14,107,137.77,6316,3054,3262,45.84452348
14,108,725.5,34182,16442,17740,47.11509304
14,109,729.31,17325,8306,9019,23.75533038
14,110,443.61,13737,6620,7117,30.9663894
14,111,351.71,6705,3333,3372,19.06400159
14,112,195.63,5798,2806,2992,29.63758115
14,113,747.45,15310,7507,7803,20.48297545
14,114,318.02,16969,8357,8612,53.35827935
14,115,673.35,5638,2785,2853,8.373060073
14,116,451.96,18711,9043,9668,41.39968139
14,117,272.28,4152,2015,2137,15.24900837
14,118,563.43,22284,10586,11698,39.55060966
14,119,479.81,27901,13698,14203,58.15010108
14,120,1163.63,1243756,607907,635849,1068.858658
14,121,252.83,29192,14181,15011,115.4609817
14,122,305.83,6685,3328,3357,21.85854887
14,123,399.81,17585,8671,8914,43.98339211
14,124,719.46,63636,31114,32522,88.44967059
14,125,262.27,17626,8501,9125,67.20555153
15,1,465.7,60918,29449,31469,130.809534
15,2,83.95,136558,68392,68166,1626.658725
15,3,453.26,44823,22043,22780,98.89026166
15,4,182.65,14856,7091,7765,81.33588831
15,5,485.21,147653,73783,73870,304.3074133
15,6,16.53,10886,5199,5687,658.5601936
15,7,222.27,22868,11224,11644,102.88388
15,8,638.55,26334,12799,13535,41.24031008
15,9,189.48,48421,23240,25181,255.5467596
15,10,75.73,27521,13576,13945,363.4094811
15,11,83.8,56243,27933,28310,671.1575179
15,12,6.92,10299,4967,5332,1488.294798
15,13,91.07,489937,238124,251813,5379.784781
15,14,267.89,93718,44905,48813,349.8376199
15,15,162.06,27663,13396,14267,170.6960385
15,16,230.94,25559,12666,12893,110.6737681
15,17,36.41,8864,4353,4511,243.4496018
15,18,101.19,47033,23061,23972,464.7988932
15,19,32.25,34101,16541,17560,1057.395349
15,20,35.1,278064,134141,143923,7922.051282
15,21,282.36,36174,17472,18702,128.1130472
15,22,14.86,12142,5976,6166,817.0928668
15,23,49.32,39030,19282,19748,791.3625304
15,24,26.32,140059,69079,70980,5321.390578
15,25,219.22,310130,151403,158727,1414.697564
15,26,292.32,27551,13532,14019,94.24945265
15,27,12.62,9676,4738,4938,766.7194929
15,28,20.7,26191,12759,13432,1265.2657
15,29,53.91,175053,85377,89676,3247.134112
15,30,6.82,22819,11138,11681,3345.894428
15,31,44.69,614453,302297,312156,13749.22802
15,32,192.03,33455,16484,16971,174.2175702
15,33,160.17,1656107,806443,849664,10339.68284
15,34,50.77,9369,4582,4787,184.5381131
15,35,118.02,100023,49372,50651,847.5088968
15,36,233.91,39864,19860,20004,170.4245223
15,37,140.67,242167,116502,125665,1721.525556
15,38,75.79,10308,5097,5211,136.0073888
15,39,327.4,467361,227846,239515,1427.492364
15,40,110.75,33541,16082,17459,302.8532731
15,41,101.35,6629,3326,3303,65.40700543
15,42,335.85,141482,68388,73094,421.2654459
15,43,116.47,26865,13058,13807,230.6602559
15,44,4.73,26328,12844,13484,5566.173362
15,45,583.95,83755,41088,42667,143.4283757
15,46,119.7,17970,8864,9106,150.1253133
15,47,272.56,69031,33299,35732,253.269005
15,48,277.26,61204,29503,31701,220.7458703
15,49,63.66,12840,6201,6639,201.6965127
15,50,140.11,23497,11503,11994,167.7039469
15,51,212.83,134799,66669,68130,633.3646572
15,52,204.95,25624,12585,13039,125.025616
15,53,17.78,50240,24570,25670,2825.646794
15,54,67.52,214162,103059,111103,3171.830569
15,55,11.47,11712,5658,6054,1021.098518
15,56,236.32,28426,13617,14809,120.2860528
15,57,156.63,833779,404974,428805,5323.239482
15,58,63.74,1110565,536943,573622,17423.36053
15,59,54.51,31691,15637,16054,581.3795634
15,60,235.65,366602,180139,186463,1555.705495
15,61,83.7,8895,4427,4468,106.2724014
15,62,134.72,61805,30365,31440,458.7663302
15,63,314.53,31803,15540,16263,101.1127714
15,64,137.47,34446,16829,17617,250.5710337
15,65,195.56,34232,17330,16902,175.0460217
15,66,157.43,4864,2464,2400,30.89627136
15,67,116.67,78146,38318,39828,669.8037199
15,68,45.64,27207,13077,14130,596.121823
15,69,3.19,4147,2012,2135,1300
15,70,36.36,253845,123956,129889,6981.435644
15,71,127.49,13002,6364,6638,101.9844694
15,72,23.4,12748,6252,6496,544.7863248
15,73,18.5,22152,10886,11266,1197.405405
15,74,368.15,121396,58173,63223,329.7460274
15,75,67.22,24851,12278,12573,369.6965189
15,76,27.38,72579,35597,36982,2650.803506
15,77,129.23,6272,3026,3246,48.53362222
15,78,104.25,9111,4458,4653,87.39568345
15,79,128.8,11798,5778,6020,91.59937888
15,80,564.04,25809,12267,13542,45.75739309
15,81,157.34,364579,177713,186866,2317.141223
15,82,669.13,71077,34411,36666,106.223006
15,83,28.75,11206,5447,5759,389.773913
15,84,163.8,35987,17916,18071,219.7008547
15,85,362.39,62695,30220,32475,173.004222
15,86,544.59,32870,16142,16728,60.35733304
15,87,190.34,90010,43963,46047,472.8906168
15,88,163.15,90946,44239,46707,557.4379405
15,89,37.77,10578,5164,5414,280.0635425
15,90,207.54,77965,38072,39893,375.6625229
15,91,53.04,63115,31240,31875,1189.95098
15,92,83.16,53010,26000,27010,637.4458874
15,93,178.37,27944,13714,14230,156.663116
15,94,42.98,18327,9003,9324,426.4076315
15,95,187.82,88559,43521,45038,471.5099563
15,96,122.32,33907,16794,17113,277.1991498
15,97,150.66,17390,8366,9024,115.4254613
15,98,24.78,5111,2506,2605,206.2550444
15,99,432.61,235151,115648,119503,543.5634867
15,100,17.46,35199,17404,17795,2015.979381
15,101,167.97,70682,34277,36405,420.8013336
15,102,172.81,15391,7389,8002,89.06313292
15,103,161.57,46130,22333,23797,285.5109241
15,104,77.17,664225,321747,342478,8607.295581
15,105,791.49,32997,16074,16923,41.68972444
15,106,452.371,819561,394836,424725,1811.701015
15,107,91.98,12099,5799,6300,131.5394651
15,108,27.22,131567,64287,67280,4833.468038
15,109,69.15,486998,238340,248658,7042.63196
15,110,430.8,61599,30296,31303,142.9874652
15,111,309.28,47709,23413,24296,154.2582773
15,112,306.56,44881,22433,22448,146.4020094
15,113,209.96,59991,29293,30698,285.7258525
15,114,419.35,94369,46657,47712,225.0363658
15,115,65.85,46331,22871,23460,703.5839028
15,116,66.67,4051,2033,2018,60.7619619
15,117,301.47,15121,7217,7904,50.15756128
15,118,308.62,167759,82109,85650,543.5778627
15,119,201.18,16365,7780,8585,81.34506412
15,120,223.95,159647,78608,81039,712.868944
15,121,109.54,511675,248552,263123,4671.124703
15,122,46.53,357645,175772,181873,7686.331399
15,123,703,27781,13719,14062,39.51778094
15,124,492.25,91345,45084,46261,185.5662773
15,125,8.47,10216,5058,5158,1206.139315
16,1,176.29,10987,5259,5728,62.32344432
16,2,1415.67,16214,8174,8040,11.45323416
16,3,159.44,20913,9984,10929,131.1653287
16,4,240.25,14684,6936,7748,61.11966701
16,5,76.11,10768,5201,5567,141.4794377
16,6,1639.92,123649,60907,62742,75.39940973
16,7,54.91,3218,1537,1681,58.60498998
16,8,2265.56,23536,11917,11619,10.38860149
16,9,696.91,34848,16925,17923,50.00358726
16,10,3460.73,21790,10846,10944,6.296359439
16,11,67.55,10653,5138,5515,157.7054034
16,12,922.16,42234,21308,20926,45.79899367
16,13,917.78,9212,4617,4595,10.03726383
16,14,365.84,14136,7256,6880,38.63984255
16,15,2826.92,17615,8601,9014,6.231163245
16,16,393.56,20492,9360,11132,52.06829962
16,17,380.74,32954,16007,16947,86.55250302
16,18,173.27,8952,4191,4761,51.66503145
16,19,505.28,19644,9259,10385,38.87745408
16,20,255.17,28227,13253,14974,110.6203707
16,21,233.62,12163,5649,6514,52.06317952
16,22,323.16,21723,11463,10260,67.22057185
16,23,151.55,9975,4847,5128,65.81986143
16,24,222.8,18141,8701,9440,81.42280072
16,25,304.51,36293,17360,18933,119.18492
16,26,1021.92,5271,2696,2575,5.157937999
16,27,191.88,5166,2320,2846,26.92307692
16,28,229.21,5564,2599,2965,24.27468261
16,29,1115.26,14366,7167,7199,12.88130122
16,30,304.55,12855,5855,7000,42.20981776
16,31,424.45,16218,7785,8433,38.20944752
16,32,246.53,14555,7005,7550,59.03946781
16,33,367.33,21294,10500,10794,57.96967305
16,34,1143.6,117620,56532,61088,102.8506471
16,35,1951.91,32757,16176,16581,16.78202376
16,36,95.65,11592,5399,6193,121.1918453
16,37,201.06,7983,3639,4344,39.7045658
16,38,2058.3,41937,20531,21406,20.37458096
16,39,79.23,7925,3883,4042,100.025243
16,40,176.86,16427,7886,8541,92.8813751
16,41,125.54,14766,6983,7783,117.6198821
16,42,124.36,13584,6621,6963,109.2312641
16,43,118.69,64011,30951,33060,539.3124947
16,44,195.05,13275,6285,6990,68.05947193
16,45,242.81,34199,16134,18065,140.8467526
16,46,141.64,13604,6592,7012,96.0463146
16,47,266.38,19986,9762,10224,75.02815527
16,48,83.7,5506,2665,2841,65.78255675
16,49,1018.76,17427,8700,8727,17.10608976
16,50,696.67,80258,38228,42030,115.2023196
16,51,232.85,13031,6309,6722,55.96306635
16,52,1152.04,178817,89221,89596,155.2177008
16,53,1196.95,729279,348994,380285,609.2810894
16,54,184.22,8091,3630,4461,43.92031267
16,55,378.64,44963,22135,22828,118.7486795
16,56,304.35,27174,13090,14084,89.28536225
16,57,548.03,7799,3835,3964,14.23097276
16,58,234.84,18834,9108,9726,80.19928462
16,59,330.13,8240,4101,4139,24.9598643
16,60,77.52,9599,4557,5042,123.8261094
16,61,145.71,22628,11242,11386,155.2947636
16,62,170.58,19450,9430,10020,114.0227459
16,63,289.01,16064,7514,8550,55.5828518
16,64,502.13,25343,12681,12662,50.47099357
16,65,244.15,34721,16422,18299,142.2117551
16,66,438.47,87794,41827,45967,200.2280658
16,67,371.47,17159,7986,9173,46.19215549
16,68,332.59,25296,12566,12730,76.05760847
16,69,285.51,99576,47492,52084,348.7653672
16,70,192.75,15306,7423,7883,79.40856031
16,71,718.65,67837,31746,36091,94.39504627
16,72,233.83,13550,6546,7004,57.94808194
16,73,213.4,25592,12109,13483,119.9250234
16,74,129.83,9980,4863,5117,76.86975275
16,75,480.97,64141,31265,32876,133.3575899
16,76,128.18,72841,35298,37543,568.2711812
16,77,468.01,18461,9044,9417,39.44573834
16,78,103.65,12618,5767,6851,121.7366136
16,79,486.49,45217,21796,23421,92.94538428
16,80,257.88,18427,8829,9598,71.45571584
16,81,264.94,8704,4310,4394,32.85272137
16,82,788.69,69955,34010,35945,88.69771393
16,83,714.43,29414,14727,14687,41.1712834
16,84,315.5,27822,13277,14545,88.18383518
16,85,386.05,32677,15740,16937,84.6444761
16,86,227.78,15176,7354,7822,66.62569146
16,87,185.08,13558,6636,6922,73.25480873
16,88,256.95,78623,37951,40672,305.9856003
16,89,780.22,22987,11559,11428,29.46220297
16,90,187.5,13950,6731,7219,74.4
16,91,174.09,13511,6448,7063,77.60928256
16,92,1493.46,14274,7143,7131,9.557671448
16,93,189.71,27587,13104,14483,145.4166886
16,94,203.79,6890,3344,3546,33.80931351
16,95,506.35,11504,5674,5830,22.71946282
16,96,2064.49,7890,3972,3918,3.821767119
16,97,1544.17,31877,15364,16513,20.64345247
16,98,243.5,26026,12502,13524,106.8829569
16,99,1017.28,16305,8060,8245,16.02803555
16,100,167.95,13556,6344,7212,80.71449836
16,101,941.21,9166,4633,4533,9.738528065
16,102,1014.34,315350,152442,162908,310.8918114
16,103,227.4,23457,11527,11930,103.1530343
16,104,350.79,16991,8063,8928,48.43638644
16,105,147.18,18995,9288,9707,129.0596548
16,106,174.91,29995,14505,15490,171.4881939
16,107,454.14,73455,35300,38155,161.7452768
16,108,335.55,186102,89746,96356,554.6177917
16,109,113.38,3247,1479,1768,28.6382078
16,110,597.41,46666,22275,24391,78.11385815
16,111,159.93,15222,7441,7781,95.17914087
16,112,510.9,155534,74715,80819,304.4313956
16,113,220.44,25576,12029,13547,116.0225005
17,1,116.79,17021,8223,8798,145.7402175
17,2,79.82,18895,9240,9655,236.7201203
17,3,143.1,33695,16458,17237,235.46471
17,4,377.82,78866,38186,40680,208.7396115
17,5,83.27,9471,4684,4787,113.7384412
17,6,96.99,175207,83676,91531,1806.443963
17,7,200.41,365168,172901,192267,1822.104685
17,8,68.37,83485,40761,42724,1221.076496
17,9,191.18,17340,8527,8813,90.699864
17,10,102.12,15646,7629,8017,153.2119076
17,11,55.49,196953,94766,102187,3549.342224
17,12,153.41,55115,26430,28685,359.2660192
17,13,90.27,14604,7002,7602,161.7813227
17,14,57.81,9456,4578,4878,163.5703166
17,15,214.49,24990,12107,12883,116.5089282
17,16,86.91,16858,8273,8585,193.9707744
17,17,297.43,61585,30152,31433,207.0571227
17,18,102.89,108126,52374,55752,1050.889299
17,19,367.67,25346,12280,13066,68.93681834
17,20,252.87,41629,20291,21338,164.6260925
17,21,67.93,7441,3680,3761,109.5392316
17,22,98.46,19138,9207,9931,194.3733496
17,23,109.62,6636,3330,3306,60.53639847
17,24,238.06,48881,23865,25016,205.3305889
17,25,543.59,31534,15608,15926,58.01063301
17,26,57.33,16543,8102,8441,288.5574743
17,27,60.08,10789,5247,5542,179.5772304
17,28,92.93,63382,32161,31221,682.0402453
17,29,192.11,97827,47581,50246,509.2238822
17,30,176.41,46809,22967,23842,265.3421008
17,31,26.28,35063,16934,18129,1334.208524
17,32,53.77,9087,4452,4635,168.9975823
17,33,37.04,14641,6916,7725,395.275378
17,34,54.23,0,0,0,0
17,35,63.34,0,0,0,0
17,36,75,0,0,0,0
19,1,47.45,2791,1406,1385,58.81981033
19,2,978.99,3443,1777,1666,3.516889856
19,3,696.75,1374,708,666,1.972012917
19,4,190.52,32593,16440,16153,171.073903
19,5,4572.87,18480,9219,9261,4.041225751
19,6,238.03,523370,263374,259996,2198.756459
19,7,2664.8,15470,7869,7601,5.80531372
19,8,465.62,3773,1890,1883,8.103174262
19,9,1140.97,86445,43939,42506,75.7644811
19,10,102.38,16092,8175,7917,157.1791366
19,11,1006.89,7855,4049,3806,7.801249392
19,12,146.56,24526,12476,12050,167.3444323
19,13,4292.05,10864,5585,5279,2.531191389
19,14,5091.18,35445,17849,17596,6.962040234
19,15,720.74,1716,889,827,2.380886311
19,16,615.78,3345,1713,1632,5.432134853
19,17,7010.79,39991,20237,19754,5.704207372
19,18,1040.01,143668,72640,71028,138.1409794
19,19,72.01,122659,57622,65037,1703.360644
19,20,1894.8,5527,2876,2651,2.916930547
19,21,151.27,357937,180332,177605,2366.212732
19,22,2479.16,14437,7234,7203,5.823343391
19,23,388.05,1277,626,651,3.29081304
19,24,1314.52,5942,3052,2890,4.520281167
19,25,184.87,55213,27787,27426,298.6585168
19,26,117.79,678006,336731,341275,5756.05739
19,27,497.27,2030,1001,1029,4.0822893
19,28,444.11,1594,829,765,3.589200874
19,29,127.8,6914,3424,3490,54.10015649
19,30,561.88,3558,1844,1714,6.332312949
19,31,247,256970,129324,127646,1040.364372
19,32,3428.68,5349,2700,2649,1.560075598
19,33,2539.67,78669,39104,39565,30.97607169
19,34,264.23,5488,2808,2680,20.7697839
19,35,207.92,862,433,429,4.145825317
19,36,1006.78,7095,3555,3540,7.047219849
19,37,3872.26,5447,2774,2673,1.406672073
19,38,1869.3,59113,29370,29743,31.62306746
19,39,892,1135550,561656,573894,1273.038117
19,40,1172.66,1034,512,522,0.881756008
19,41,308.89,20843,10737,10106,67.47709541
19,42,1341.58,5359,2720,2639,3.994543747
19,43,673.76,2628,1363,1265,3.900498694
19,44,1542.15,34671,17214,17457,22.48224881
19,45,1658.08,32660,16800,15860,19.69748142
19,46,60.1,443273,219337,223936,7375.590682
19,47,170.12,16604,8318,8286,97.60169292
19,48,885.01,268955,134388,134567,303.9005209
19,49,746.48,40469,20341,20128,54.21310685
19,50,1766.28,1971,1065,906,1.115904613
19,51,879.68,4113,2073,2040,4.675563841
21,1,185.46,60353,29225,31128,325.4232719
21,2,180.67,8916,4484,4432,49.349643
21,3,607.78,33865,15545,18320,55.7191747
21,4,140.53,52078,25298,26780,370.5827937
21,5,74.84,2881,1340,1541,38.49545697
21,6,90.98,14754,7087,7667,162.1675093
21,7,184.07,3403,1662,1741,18.48753192
21,8,60.53,10457,5127,5330,172.7573104
21,9,72.71,2008,935,1073,27.61655893
21,10,394.68,60621,29304,31317,153.5953177
21,11,79.51,1770,811,959,22.26135077
21,12,52.38,6288,2934,3354,120.045819
21,13,47.8,18920,9109,9811,395.8158996
21,14,44.98,5004,2370,2634,111.2494442
21,15,135.18,100964,49098,51866,746.885634
21,16,166.52,7848,3900,3948,47.12947394
21,17,48.11,25386,12278,13108,527.665766
21,18,331.39,3734,1790,1944,11.26769064
21,19,293.01,127062,59360,67702,433.6439029
21,20,26.56,6426,3099,3327,241.9427711
21,21,11.36,1228,585,643,108.0985915
21,22,129.74,11684,5329,6355,90.05703715
21,23,133.12,8408,4118,4290,63.16105769
21,24,188.17,947,439,508,5.032683212
21,25,107.04,8153,3993,4160,76.16778774
21,26,66.88,13730,6464,7266,205.2930622
21,27,391.74,4177,1953,2224,10.66268443
21,28,16.24,2476,1214,1262,152.4630542
21,29,13.97,3791,1810,1981,271.3672155
21,30,12.24,758,359,399,61.92810458
21,31,116.01,2964,1403,1561,25.54952159
21,32,240.61,1283,646,637,5.332280454
21,33,47.32,4763,2258,2505,100.6551141
21,34,36.78,34596,16758,17838,940.6199021
21,35,247.68,19639,9368,10271,79.29182817
21,36,228.81,14205,6801,7404,62.08207683
21,37,133.77,2339,1081,1258,17.48523585
21,38,23.35,8709,4286,4423,372.9764454
21,39,61.56,9212,4408,4804,149.6426251
21,40,159.93,9538,4697,4841,59.63859188
21,41,38.17,79153,38477,40676,2073.69662
21,42,200.66,3062,1457,1605,15.25964318
21,43,181.73,47433,23240,24193,261.0080889
21,44,300.79,15367,7412,7955,51.08879949
21,45,389.82,43882,21092,22790,112.5699041
21,46,87,6992,3343,3649,80.36781609
21,47,804.3,19037,9191,9846,23.66902897
21,48,81.22,18762,8846,9916,231.0022162
21,49,89.34,15767,7696,8071,176.4830983
21,50,108.95,24148,11918,12230,221.6429555
21,51,325.28,33935,16288,17647,104.3255042
21,52,26.27,1227,581,646,46.70727065
21,53,760.23,57909,28228,29681,76.17300028
21,54,148.29,30254,14669,15585,204.0191517
21,55,128.27,4699,2169,2530,36.63366337
21,56,140.86,1237,571,666,8.781769132
21,57,63.59,7463,3552,3911,117.3612203
21,58,146.95,19257,9682,9575,131.044573
21,59,88.36,2468,1151,1317,27.93119058
21,60,12.14,6946,3296,3650,572.1581549
21,61,99.67,12575,6181,6394,126.166349
21,62,51.93,4594,2216,2378,88.46524167
21,63,79.03,13785,6593,7192,174.4274326
21,64,430.68,16270,8154,8116,37.77746819
21,65,91.67,19040,9125,9915,207.7015381
21,66,154.73,6276,2919,3357,40.56097719
21,67,224.42,16551,8006,8545,73.7501114
21,68,50.39,7718,3849,3869,153.1653106
21,69,231.48,25373,11681,13692,109.6120615
21,70,168.53,6643,3051,3592,39.41731442
21,71,250.41,97753,46336,51417,390.3717903
21,72,47.95,15689,7706,7983,327.1949948
21,73,180.66,8679,4179,4500,48.0405181
21,74,175.36,63457,30723,32734,361.8670164
21,75,74.54,11868,5787,6081,159.216528
21,76,319.7,26689,13208,13481,83.4813888
21,77,42.29,5734,2827,2907,135.5876094
21,78,69.45,13982,7049,6933,201.324694
21,79,51,5306,2534,2772,104.0392157
21,80,12.51,2833,1328,1505,226.4588329
21,81,308.31,3695,1756,1939,11.98469073
21,82,106.58,8093,3857,4236,75.93357103
21,83,567.96,25326,12524,12802,44.59116839
21,84,19.5,6811,3285,3526,349.2820513
21,85,537.33,72799,34451,38348,135.4828504
21,86,206.05,12547,6067,6480,60.89298714
21,87,600.15,12662,6006,6656,21.09805882
21,88,30.17,4598,2237,2361,152.4030494
21,89,170.81,12997,6327,6670,76.09039283
21,90,23.03,18540,8881,9659,805.0369084
21,91,23.15,10213,4800,5413,441.1663067
21,92,225.48,5223,2562,2661,23.16391698
21,93,179.66,7767,3806,3961,43.2316598
21,94,275.48,31532,15224,16308,114.4620299
21,95,11.1,484,242,242,43.6036036
21,96,54.63,2633,1303,1330,48.19696138
21,97,9.43,2216,1032,1184,234.9946978
21,98,156.37,6218,2902,3316,39.76466074
21,99,244.85,18954,9132,9822,77.41065959
21,100,60.45,9707,4610,5097,160.5789909
21,101,27.73,3598,1695,1903,129.751172
21,102,18.81,12011,5746,6265,638.543328
21,103,108.92,6009,2915,3094,55.16893133
21,104,687.38,27292,13259,14033,39.70438477
21,105,67.13,4825,2329,2496,71.87546551
21,106,119.66,25720,12128,13592,214.9423366
21,107,63.05,11641,5681,5960,184.631245
21,108,239.67,16575,8009,8566,69.15759169
21,109,99.14,20618,9905,10713,207.9685294
21,110,362.53,42887,20914,21973,118.2991752
21,111,222.27,18435,8947,9488,82.93966797
21,112,233.55,9382,4356,5026,40.17126954
21,113,221.28,4585,2187,2398,20.7203543
21,114,544.65,1539819,734352,805467,2827.171578
21,115,187.32,47281,23041,24240,252.4076447
21,116,165.91,21275,10572,10703,128.2321741
21,117,4.1,14052,6679,7373,3427.317073
21,118,58.71,25553,12390,13163,435.2410152
21,119,79.89,100439,48650,51789,1257.216172
21,120,79.89,5110,2393,2717,63.96294905
21,121,133.16,1132,549,583,8.501051367
21,122,39.38,9426,4564,4862,239.3600813
21,123,45.09,4120,2022,2098,91.37280994
21,124,109.02,14454,6818,7636,132.5811778
21,125,11.77,8170,3864,4306,694.1376381
21,126,39.72,5826,2762,3064,146.6767372
21,127,142.58,3777,1757,2020,26.49039136
21,128,176.98,8087,3966,4121,45.69442875
21,129,333.35,12699,5941,6758,38.09509525
21,130,96.36,3416,1582,1834,35.45039435
21,131,24.76,872,442,430,35.2180937
21,132,83.02,141112,67505,73607,1699.735004
21,133,7.27,651,313,338,89.54607978
21,134,51.5,19310,9406,9904,374.9514563
21,135,72.61,586,282,304,8.070513703
21,136,6.46,11598,5624,5974,1795.356037
21,137,210.17,9185,4471,4714,43.70271685
21,138,162.45,10777,5190,5587,66.34041243
21,139,97.39,3554,1690,1864,36.49245302
21,140,76.32,120459,57578,62881,1578.341195
21,141,174.98,3395,1628,1767,19.4022174
21,142,220.29,27622,13391,14231,125.3892596
21,143,108.71,28419,13816,14603,261.4202925
21,144,23.85,13541,6663,6878,567.7568134
21,145,236.29,13534,6668,6866,57.27707478
21,146,47.44,874,439,435,18.4232715
21,147,283.65,5944,2861,3083,20.95540279
21,148,32.68,8040,3853,4187,246.0220318
21,149,93.7,21993,10595,11398,234.7171825
21,150,180.66,7060,3418,3642,39.0789328
21,151,19.46,8016,3822,4194,411.9218911
21,152,115.2,11706,5702,6004,101.6145833
21,153,176.04,20267,9770,10497,115.1272438
21,154,180.22,71571,34365,37206,397.131284
21,155,145.67,5420,2578,2842,37.20738656
21,156,553.67,274906,129484,145422,496.5159752
21,157,492.16,11328,5360,5968,23.01690507
21,158,140.23,6772,3327,3445,48.29209156
21,159,248.62,4024,1807,2217,16.18534309
21,160,136.37,3121,1514,1607,22.88626531
21,161,224.65,19002,8916,10086,84.58490986
21,162,28.67,4244,2003,2241,148.0292989
21,163,69.39,16275,7831,8444,234.5438824
21,164,217.46,74708,35672,39036,343.5482388
21,165,29.76,1141,547,594,38.34005376
21,166,132.25,8056,3655,4401,60.91493384
21,167,70.88,10240,4944,5296,144.469526
21,168,116.42,6580,3160,3420,56.51949837
21,169,392.3,20478,10400,10078,52.19984706
21,170,450.45,16390,8087,8303,36.38583639
21,171,15.35,3365,1601,1764,219.218241
21,172,328.8,25793,12341,13452,78.44586375
21,173,9.83,5689,2633,3056,578.7385554
21,174,92.64,92246,43462,48784,995.7469775
21,175,133.22,9807,4626,5181,73.61507281
21,176,83.89,8401,4016,4385,100.1430445
21,177,398.56,48268,22926,25342,121.1059815
21,178,173.83,17115,8406,8709,98.45826382
21,179,422.217,28568,13950,14618,67.6618895
21,180,311.97,36518,17975,18543,117.0561272
21,181,20.88,6269,3103,3166,300.2394636
21,182,14.88,4833,2325,2508,324.7983871
21,183,143.14,19826,9672,10154,138.5077546
21,184,63.26,6406,3128,3278,101.2646222
21,185,83.79,8404,3930,4474,100.298365
21,186,294.15,51495,24722,26773,175.063743
21,187,54.63,5415,2663,2752,99.12136189
21,188,218.94,17028,7916,9112,77.7747328
21,189,102.1,19701,9439,10262,192.9578844
21,190,148.15,1155,526,629,7.796152548
21,191,277.61,9245,4275,4970,33.30211448
21,192,41.93,5983,2892,3091,142.6901979
21,193,279.11,6242,3062,3180,22.36394253
21,194,316.56,27890,13474,14416,88.10336113
21,195,244.36,24217,11592,12625,99.10378131
21,196,59.91,1649,752,897,27.52462026
21,197,312.3,75601,36390,39211,242.07813
21,198,205.22,1241,583,658,6.047168892
21,199,145.45,37910,18326,19584,260.639395
21,200,59.73,3911,1906,2005,65.47798426
21,201,46.61,3187,1437,1750,68.375885
21,202,78.2,12249,5977,6272,156.6368286
21,203,163.72,6049,2872,3177,36.94722697
21,204,29.82,7514,3613,3901,251.9785379
21,205,125.77,22976,11113,11863,182.6826747
21,206,248.39,4224,1962,2262,17.00551552
21,207,176.64,53295,25534,27761,301.7153533
21,208,489.33,76296,36133,40163,155.9193183
21,209,427.75,8220,3712,4508,19.21683226
21,210,20.3,5608,2779,2829,276.2561576
21,211,30.9,15444,7152,8292,499.8058252
21,212,266.7,19438,9186,10252,72.88338958
21,213,176.53,12530,6112,6418,70.97943692
21,214,62.94,15690,7374,8316,249.2850334
21,215,36.73,4599,2258,2341,125.2109992
21,216,18.92,2639,1251,1388,139.4820296
21,217,268.87,20529,9987,10542,76.35288429
22,1,710.9,62197,29842,32355,87.49050499
22,2,711.97,27093,12859,14234,38.05356967
22,3,726.89,12910,6122,6788,17.76059651
22,4,1349.98,64183,30585,33598,47.54366731
22,5,810.39,58171,28975,29196,71.78148793
22,6,234.35,143073,69373,73700,610.5099211
22,7,300.56,38123,18213,19910,126.8398989
22,8,388.31,35554,16930,18624,91.56086632
22,9,1189.76,25550,12192,13358,21.47491931
22,10,719.15,19929,9501,10428,27.71188208
22,11,687.58,116458,57547,58911,169.3737456
22,12,323.27,63966,31387,32579,197.8717481
22,13,704.83,18441,9013,9428,26.1637558
22,14,740.93,801940,389403,412537,1082.342462
22,15,277.41,8865,4109,4756,31.95631015
22,16,766.94,241699,117628,124071,315.1472084
22,17,360.06,63413,30752,32661,176.1178692
22,18,680.51,26372,12757,13615,38.75328798
24,1,775.62,18644,8775,9869,24.03754416
24,2,586.75,8186,4068,4118,13.95142735
24,3,793.52,47423,23894,23529,59.76282891
24,4,623.23,4436,2182,2254,7.117757489
24,5,390.85,18937,9103,9834,48.45081233
24,6,1945.17,9716,4932,4784,4.994936175
24,7,1163.9,18485,9048,9437,15.88194862
24,8,962.38,21394,10373,11021,22.23030404
24,9,123.38,4021,2031,1990,32.59037121
24,10,3140.65,31323,15523,15800,9.973413147
24,11,519.35,43528,21258,22270,83.81245788
24,12,137.43,21039,10406,10633,153.0888452
24,13,2417.75,167713,81226,86487,69.36738703
24,14,90.19,17015,8544,8471,188.6572791
24,15,2161.8,21138,10328,10810,9.777962809
24,16,698.79,41529,20347,21182,59.42987164
24,17,3703.79,25985,13158,12827,7.015786532
24,18,71.51,15311,7554,7757,214.1099147
24,19,539.68,5774,2839,2935,10.6989327
24,20,1286.6,91522,44343,47179,71.13477382
24,21,889.42,53442,25449,27993,60.08634841
24,22,1283.39,19327,9298,10029,15.05933504
24,23,785.07,15707,7739,7968,20.00713312
24,24,3072.09,91924,44574,47350,29.92230045
24,25,1756.9,30190,14548,15642,17.18367579
24,26,94.63,9390,4800,4590,99.22857445
24,27,637.06,10171,4875,5296,15.96552915
24,28,1471.71,772604,372083,400521,524.9702727
24,29,413.28,21347,10686,10661,51.6526326
24,30,692.81,5466,2587,2879,7.889608984
24,31,640.89,11835,5805,6030,18.46650751
24,32,1716.68,40326,19242,21084,23.49069133
24,33,4352.96,12043,6022,6021,2.766623171
24,34,517.97,14958,7451,7507,28.87812035
24,35,304.86,267839,129814,138025,878.563931
24,36,1321.58,28848,14563,14285,21.8284175
24,37,354.1,96820,47951,48869,273.425586
24,38,185.21,15838,7975,7863,85.51374116
24,39,264.62,14274,7081,7193,53.94150102
24,40,1842.03,37956,18672,19284,20.6055276
24,41,375.46,19312,9725,9587,51.43557236
24,42,142.79,14382,7077,7305,100.721339
24,43,479.26,9024,4268,4756,18.82902808
24,44,2598.13,7902,3974,3928,3.041418251
24,45,1294.26,14492,7149,7343,11.19713195
24,46,878.53,16316,8117,8199,18.57193266
24,47,1913.25,9779,4920,4859,5.111198223
24,48,143.93,5350,2694,2656,37.17084694
24,49,2505.89,37928,18590,19338,15.13554067
24,50,1004.99,46898,23204,23694,46.66514095
24,51,1520.42,14876,7361,7515,9.784138593
24,52,638.31,10174,4988,5186,15.93896383
24,53,192.58,33245,16471,16774,172.6295565
24,54,398.44,51498,25484,26014,129.2490714
24,55,614.11,24596,12105,12491,40.05145658
24,56,584.99,15528,7713,7815,26.54404349
24,57,116.09,30299,15053,15246,260.9957791
24,58,830.74,20495,10326,10169,24.67077545
26,1,367.96,2637,1405,1232,7.166539841
26,2,3943.07,79138,40117,39021,20.07014839
26,3,6426.22,25848,13497,12351,4.022271257
26,4,4455.44,9049,4624,4425,2.031000305
26,5,662.58,1253,650,603,1.891092396
26,6,3073.17,3037,1571,1466,0.988230394
26,7,298.13,625,326,299,2.096400899
26,8,1066.38,1252,667,585,1.17406553
26,9,1131.11,784,417,367,0.693124453
26,10,1343.86,1467,761,706,1.091631569
26,11,1231.69,1646,834,812,1.336375224
26,12,1578.16,22821,11581,11240,14.46051097
26,13,807.7,1646,841,805,2.037885353
26,14,841.95,3560,1833,1727,4.228279589
26,15,1722.43,1454,774,680,0.844156221
26,16,1408.55,5275,2651,2624,3.744985978
26,17,10737.35,81309,41370,39939,7.572538848
26,18,4882.65,409310,202700,206610,83.82947785
26,19,2312.01,32936,16415,16521,14.24561312
26,20,2583.28,5347,2854,2493,2.069849184
26,21,4123.05,1663,922,741,0.403342186
26,22,1567.99,958,532,426,0.610973284
26,23,2010.43,6362,3248,3114,3.164497147
26,24,394.16,813,421,392,2.062614167
26,25,593.22,54131,26996,27135,91.24945214
26,26,949.85,60717,31131,29586,63.92272464
26,27,2624.36,8639,4467,4172,3.291850203
26,28,363.93,1150,595,555,3.159948342
26,29,7987.23,149299,74740,74559,18.69221244
26,30,15720.35,784342,392697,391645,49.8934184
26,31,1198.24,1350,701,649,1.126652424
26,32,821.9,962,513,449,1.170458693
26,33,1933.2,79313,40128,39185,41.02679495
26,34,421.92,1154,593,561,2.735115662
26,35,2171.11,12316,6248,6068,5.672674346
26,36,1240.94,29707,14848,14859,23.93911067
26,37,684.42,1350,708,642,1.972473043
26,38,1867.36,4680,2351,2329,2.506211978
26,39,1238.9,6401,3238,3163,5.166680119
26,40,2832.84,2051,1080,971,0.724008416
26,41,1735.45,12751,6575,6176,7.34737388
26,42,2778.12,157729,78242,79487,56.77544527
26,43,1754.24,220292,111295,108997,125.576888
26,44,535.28,399,214,185,0.745404274
26,45,2237.09,2878,1538,1340,1.28649272
26,46,916.76,443,218,225,0.483223526
26,47,9823.33,9468,4936,4532,0.963827948
26,48,6163.03,57342,29460,27882,9.30418966
26,49,3711.37,3356,1797,1559,0.904248296
26,50,880.36,1599,852,747,1.816302422
26,51,3593.51,5226,2737,2489,1.454288426
26,52,5064.46,6020,3109,2911,1.188675594
26,53,151.38,396,202,194,2.615933413
26,54,537.1,492,277,215,0.916030534
26,55,8910.37,178380,90545,87835,20.01937069
26,56,1119.83,8382,4592,3790,7.485064697
26,57,2230.59,1604,856,748,0.719092258
26,58,1481.38,16014,7961,8053,10.8101905
26,59,1001.81,1998,1015,983,1.994390154
26,60,1329.33,2703,1423,1280,2.033355149
26,61,1716.77,1284,716,568,0.747916145
26,62,915.35,1121,604,517,1.22466816
26,63,779.86,1365,716,649,1.750314159
26,64,3008.28,1731,938,793,0.575411863
26,65,1750.41,1735,904,831,0.991196348
26,66,3087.14,9185,4711,4474,2.975245697
26,67,1471.65,1738,893,845,1.180987327
26,68,1124.31,1254,688,566,1.115350748
26,69,2665.93,6046,3064,2982,2.267876501
26,70,3655.92,15652,8104,7548,4.281275301
26,71,369.1,22009,11088,10921,59.62882688
26,72,1384.28,14136,7297,6839,10.21180686
28,1,1858.83,12070,6041,6029,6.493331827
28,2,3819.16,29470,14857,14613,7.716356476
28,3,1662.36,212001,105619,106382,127.5301379
28,4,579.03,9003,4494,4509,15.54841718
28,5,1866.38,4589,2377,2212,2.458770454
28,6,1426.77,7636,3953,3683,5.351948807
28,7,930.66,14933,7567,7366,16.04560205
28,8,3012.79,4423,2326,2097,1.468074443
28,9,48.46,197216,94384,102832,4069.665704
28,10,1888.48,2011,1023,988,1.064877573
28,11,727.94,8786,4507,4279,12.06967607
28,12,3236.46,43435,21554,21881,13.42052737
28,13,1193.79,15659,8091,7568,13.11704739
28,14,2427.19,4477,2316,2161,1.844519794
28,15,431.12,15775,7979,7796,36.5907404
28,16,2146.92,23793,12203,11590,11.08238779
28,17,2642.29,15105,7605,7500,5.716632164
28,18,1670.14,8338,4183,4155,4.992395847
28,19,2577.4,17333,8783,8550,6.72499418
28,20,386.76,2579,1313,1266,6.668218016
28,21,1641.66,115792,56501,59291,70.5334844
28,22,4634,489193,242234,246959,105.5660337
28,23,2518.68,4530,2359,2171,1.798561151
28,24,928.6,4762,2350,2412,5.128149903
28,25,636.47,27015,13467,13548,42.44504847
28,26,887.8,3514,1850,1664,3.958098671
28,27,1201.9,384033,191001,193032,319.5215908
28,28,303.12,3381,1753,1628,11.15399842
28,29,1494.52,12962,6603,6359,8.673018762
28,30,1360.89,14020,7100,6920,10.30208173
28,31,478.05,1795,901,894,3.75483736
28,32,3138.97,608891,303853,305038,193.9779609
28,33,1583.54,118259,59174,59085,74.68014701
28,34,2920.98,9331,4897,4434,3.194475827
28,35,6922.78,57220,28800,28420,8.265465608
28,36,544.72,1031,535,496,1.892715524
28,37,6715.79,24764,12664,12100,3.687429178
28,38,114.52,297554,142334,155220,2598.271044
28,39,3082.69,27572,13717,13855,8.944136452
28,40,899.98,63170,31061,32109,70.19044868
28,41,1469.97,321953,157152,164801,219.0201161
28,42,1284.52,6316,3276,3040,4.917011802
28,43,877.61,22864,11444,11420,26.05257461
29,1,11.5,9875,4819,5056,858.6956522
29,2,11.63,13361,6424,6937,1148.839209
29,3,108.13,6018,2914,3104,55.65522982
29,4,186.46,15935,7904,8031,85.46068862
29,5,43.46,76492,36269,40223,1760.055223
29,6,254.82,44807,21730,23077,175.8378463
29,7,58.52,15368,7527,7841,262.6110731
29,8,84.69,13671,6801,6870,161.424017
29,9,16.58,5066,2504,2562,305.548854
29,10,77.09,66149,31651,34498,858.0749773
29,11,36.34,4285,2156,2129,117.9141442
29,12,140.18,8399,4151,4248,59.91582251
29,13,340.33,84979,41296,43683,249.6958834
29,14,175.86,13879,6839,7040,78.9207324
29,15,29.93,35162,16917,18245,1174.807885
29,16,43.56,6791,3245,3546,155.8999082
29,17,14.68,9740,4764,4976,663.4877384
29,18,26.27,35084,17162,17922,1335.515797
29,19,28.68,18725,8990,9735,652.8940028
29,20,100.48,8474,4167,4307,84.33519108
29,21,109.29,16640,8127,8513,152.2554671
29,22,14.95,5711,2846,2865,382.006689
29,23,56.3,23621,11330,12291,419.5559503
29,24,61.29,25128,12073,13055,409.9853157
29,25,60.28,69615,34281,35334,1154.86065
29,26,25.9,17968,8832,9136,693.7451737
29,27,12.05,11763,5732,6031,976.1825726
29,28,77.91,21671,10426,11245,278.1542806
29,29,16.58,11048,5233,5815,666.344994
29,30,150.76,13775,6838,6937,91.37039002
29,31,169.89,28760,14026,14734,169.2860086
29,32,25.24,12410,5980,6430,491.6798732
29,33,52.46,89795,42529,47266,1711.685093
29,34,573.39,39939,19507,20432,69.65416209
29,35,14.27,5589,2756,2833,391.6608269
29,36,13.89,20625,9854,10771,1484.88121
29,37,69.17,8224,3935,4289,118.8954749
29,38,38.39,14611,7083,7528,380.5939047
29,39,41.9,21769,10847,10922,519.5465394
29,40,102.66,9777,4701,5076,95.23670368
29,41,24.46,26997,12969,14028,1103.72036
29,42,7.33,12255,5856,6399,1671.896317
29,43,36.68,33081,15941,17140,901.8811341
29,44,31.38,38654,18499,20155,1231.803697
29,45,25.85,5687,2757,2930,220
29,46,49.26,4146,1999,2147,84.16565164
29,47,25.42,2769,1349,1420,108.9299764
29,48,11.71,16834,8089,8745,1437.574722
29,49,10.17,5064,2508,2556,497.9351032
29,50,39.61,9880,4780,5100,249.4319616
29,51,7.81,3581,1681,1900,458.5147247
29,52,36.23,5660,2744,2916,156.2241237
29,53,4.5,6821,3221,3600,1515.777778
29,54,4.54,5045,2405,2640,1111.23348
29,55,28.59,2833,1342,1491,99.09059112
29,56,9.07,6857,3348,3509,756.0088203
29,57,8.06,4349,2034,2315,539.5781638
29,58,10.09,7992,3840,4152,792.0713578
29,59,5.46,6296,3109,3187,1153.113553
29,60,5.87,4436,2138,2298,755.7069847
30,1,97.69,8223,4203,4020,84.17442932
30,2,18.14,3085,1501,1584,170.0661521
30,3,655.07,83817,40242,43575,127.9512113
30,4,859.53,40994,20142,20852,47.69350692
30,5,195.4,5129,2556,2573,26.24872057
30,6,167.89,20973,10254,10719,124.9210793
30,7,125.78,6224,3103,3121,49.48322468
30,8,71.03,9691,4809,4882,136.435309
30,9,647.94,28017,14066,13951,43.24011483
30,10,328.66,60396,29014,31382,183.7643766
30,11,825.75,51955,25615,26340,62.91855889
30,12,135,7487,3650,3837,55.45925926
30,13,135.86,27548,13076,14472,202.7675548
30,14,151.05,42268,20591,21677,279.8278716
30,15,431.06,33528,16270,17258,77.7803554
30,16,131.45,25500,12286,13214,193.9901103
30,17,67.27,4027,1996,2031,59.8632377
30,18,20.63,1797,866,931,87.10615608
30,19,38.61,5995,2781,3214,155.2706553
30,20,62.14,9824,4711,5113,158.094625
30,21,122.65,22986,11078,11908,187.4113331
30,22,65.17,20063,9865,10198,307.8563756
30,23,518.12,48397,24140,24257,93.40886281
30,24,278.52,14613,7315,7298,52.46660922
30,25,172.83,25456,12693,12763,147.2892438
30,26,19.84,21546,10158,11388,1085.987903
30,27,233.43,16692,8142,8550,71.50751831
30,28,37.24,138058,64656,73402,3707.250269
30,29,134.23,12929,6433,6496,96.31974968
30,30,21.52,41778,19778,22000,1941.356877
30,31,249.15,16313,7940,8373,65.47461369
30,32,659.21,48593,23457,25136,73.71399099
30,33,273.12,23483,11378,12105,85.98052138
30,34,91,25801,12260,13541,283.5274725
30,35,81.32,11081,5418,5663,136.2641417
30,36,43.92,9416,4578,4838,214.3897996
30,37,40.39,7810,3861,3949,193.3646942
30,38,202.44,86696,41788,44908,428.2552855
30,39,309.2,305260,147962,157298,987.2574386
30,40,277.33,48351,23449,24902,174.3446436
30,41,9.45,2144,1053,1091,226.8783069
30,42,129.62,5728,2804,2924,44.19071131
30,43,311.78,18713,9527,9186,60.01988582
30,44,159.89,196541,91805,104736,1229.226343
30,45,518.2,57366,27634,29732,110.7024315
30,46,76.59,15668,7756,7912,204.5697872
30,47,157.65,52510,25561,26949,333.0796067
30,48,277.98,117725,56945,60780,423.5016908
30,49,537.81,19710,9770,9940,36.64863056
30,50,80.7,15492,7571,7921,191.9702602
30,51,234.72,21822,10516,11306,92.97034765
30,52,34.7,11645,5527,6118,335.5907781
30,53,150.2,26265,12469,13796,174.8668442
30,54,295.46,11683,5686,5997,39.54173154
30,55,151.68,12626,6221,6405,83.24103376
30,56,92.65,6752,3276,3476,72.87641662
30,57,133.86,13190,6529,6661,98.53578365
30,58,935.73,54982,26729,28253,58.75840253
30,59,174.07,15214,7404,7810,87.40162004
30,60,140.4,15286,7477,7809,108.8746439
30,61,3509.56,77426,38042,39384,22.061455
30,62,44.44,18601,9173,9428,418.5643564
30,63,390.43,14688,7349,7339,37.62005993
30,64,23.1,3889,1899,1990,168.3549784
30,65,415.67,61718,30300,31418,148.4783602
30,66,239.46,25548,12407,13141,106.6900526
30,67,43.24,16418,8180,8238,379.6947271
30,68,61.6,59761,28261,31500,970.1461039
30,69,179.27,24353,11436,12917,135.8453729
30,70,1064.61,18277,9220,9057,17.16778914
30,71,202.47,54561,26216,28345,269.4769595
30,72,515.62,20765,10014,10751,40.27190567
30,73,711.59,41649,20276,21373,58.5294903
30,74,18.66,6750,3253,3497,361.7363344
30,75,397.13,17121,8293,8828,43.11182736
30,76,155.39,13575,6423,7152,87.36083403
30,77,927.86,42205,20520,21685,45.48638803
30,78,177.47,12713,6340,6373,71.63464247
30,79,149.81,10724,5400,5324,71.58400641
30,80,129.49,21407,10541,10866,165.3177852
30,81,52.56,21150,10121,11029,402.3972603
30,82,156.84,14903,7361,7542,95.02040296
30,83,668.4,49820,24351,25469,74.53620586
30,84,347.39,5727,2856,2871,16.48579406
30,85,137.35,65385,31521,33864,476.0465963
30,86,208.12,40747,19969,20778,195.786085
30,87,124.38,457928,213571,244357,3681.685158
30,88,72.35,4940,2480,2460,68.27919834
30,89,316.13,39673,18929,20744,125.4958403
30,90,132.41,10376,5085,5291,78.36266143
30,91,1392.66,27080,13394,13686,19.44480347
30,92,179.64,35188,17276,17912,195.8806502
30,93,56.18,15313,7401,7912,272.5703097
30,94,992.61,37193,18326,18867,37.46990258
30,95,188.29,16387,8067,8320,87.03064422
30,96,17.55,1546,746,800,88.09116809
30,97,84.2,20141,9468,10673,239.2042755
30,98,13.77,2920,1443,1477,212.0551924
30,99,110.91,16898,8098,8800,152.3577676
30,100,246.75,22585,11171,11414,91.52988855
30,101,69.55,33941,16253,17688,488.0086269
30,102,402.1,101358,48561,52797,252.071624
30,103,43.65,11808,5787,6021,270.5154639
30,104,298.51,17333,8501,8832,58.06505645
30,105,398.2,59126,28431,30695,148.4831743
30,106,29.37,4429,2154,2275,150.8001362
30,107,50.64,2897,1468,1429,57.20774092
30,108,2115.2,157840,76222,81618,74.62178517
30,109,524.77,62919,30771,32148,119.8982411
30,110,66.28,10387,5221,5166,156.7139409
30,111,249.76,16120,7851,8269,64.54196028
30,112,108.77,20255,9861,10394,186.2186265
30,113,18.6,4507,2163,2344,242.311828
30,114,356,9974,4873,5101,28.01685393
30,115,63.59,34688,16604,18084,545.4945746
30,116,77.87,14784,7097,7687,189.8548863
30,117,214.66,22561,10850,11711,105.1010901
30,118,27.89,120995,55845,65150,4338.293295
30,119,50.08,5250,2511,2739,104.8322684
30,120,22.75,14965,7289,7676,657.8021978
30,121,2391.11,23276,11937,11339,9.734391141
30,122,307.52,15909,7923,7986,51.7332206
30,123,3171.23,97290,48357,48933,30.67894792
30,124,1458.5,158599,77291,81308,108.7411724
30,125,398.97,29165,14390,14775,73.10073439
30,126,387.83,32576,16252,16324,83.99556507
30,127,137.49,23648,11498,12150,171.9979635
30,128,614.66,68982,34642,34340,112.2278984
30,129,244.67,17888,8780,9108,73.11072056
30,130,1174.17,40984,19660,21324,34.90465605
30,131,63.95,193311,91390,101921,3022.845973
30,132,99.68,17958,8889,9069,180.1565008
30,133,289.28,55358,27668,27690,191.3647677
30,134,383.76,21603,10628,10975,56.29299562
30,135,26.67,20245,9978,10267,759.0926134
30,136,11.54,7023,3405,3618,608.5788562
30,137,33.78,5484,2696,2788,162.3445826
30,138,15.22,40634,19042,21592,2669.77661
30,139,108.73,5908,2864,3044,54.33642969
30,140,21.91,2715,1311,1404,123.9160201
30,141,957.21,157364,75604,81760,164.3986168
30,142,1257.65,33435,16442,16993,26.58529798
30,143,619.41,56427,27099,29328,91.09798034
30,144,662,31974,15604,16370,48.29909366
30,145,96.39,14395,6994,7401,149.341218
30,146,16.23,3502,1749,1753,215.7732594
30,147,115.66,21380,10496,10884,184.8521529
30,148,416.3,27008,13339,13669,64.87629114
30,149,479.71,32596,15964,16632,67.94938609
30,150,399.64,11211,5599,5612,28.05274747
30,151,1018.53,23588,11841,11747,23.15886621
30,152,873.84,12242,6329,5913,14.00942964
30,153,155.98,5873,2867,3006,37.65226311
30,154,334.21,12814,6483,6331,38.34116274
30,155,1303.25,101743,50432,51311,78.06867447
30,156,92.01,5584,2903,2681,60.68905554
30,157,272.02,18663,9334,9329,68.60892581
30,158,535.44,25126,12351,12775,46.92589272
30,159,94.75,23479,11298,12181,247.7994723
30,160,1278.98,104499,51618,52881,81.70495238
30,161,1152.49,34956,17311,17645,30.33084886
30,162,65.31,6247,3053,3194,95.65150819
30,163,86.96,5222,2486,2736,60.05059798
30,164,60.77,16327,7982,8345,268.668751
30,165,59.78,8249,4207,4042,137.9892941
30,166,95.12,9004,4545,4459,94.65937763
30,167,226.85,13949,6918,7031,61.48997135
30,168,99.74,14648,7202,7446,146.8618408
30,169,543.22,23999,11727,12272,44.17915393
30,170,195.94,10627,5149,5478,54.23599061
30,171,44.04,5292,2492,2800,120.1634877
30,172,450.39,20199,10063,10136,44.84779857
30,173,524.56,52584,25931,26653,100.244014
30,174,1516.75,94087,45203,48884,62.03197627
30,175,718.8,89774,43978,45796,124.8942682
30,176,103.01,4632,2285,2347,44.96650811
30,177,133.57,10299,5189,5110,77.10563749
30,178,577.59,13284,6415,6869,22.99901314
30,179,65.4,3965,1944,2021,60.62691131
30,180,225.48,11276,5563,5713,50.00886997
30,181,917.68,37037,18181,18856,40.35938453
30,182,36.61,16311,7940,8371,445.5340071
30,183,167.96,58084,28079,30005,345.8204334
30,184,57.19,7151,3333,3818,125.0393425
30,185,11.06,4879,2358,2521,441.1392405
30,186,18.85,6763,3330,3433,358.7798408
30,187,50.37,5696,2752,2944,113.0831844
30,188,97.76,16403,8176,8227,167.7884615
30,189,966.18,143362,69764,73598,148.380219
30,190,45.63,2177,1078,1099,47.70984002
30,191,123.92,29005,14077,14928,234.0622983
30,192,340.17,19541,9477,10064,57.44480701
30,193,247.9,552156,261537,290619,2227.333602
30,194,51.4,10851,5333,5518,211.1089494
30,195,37.17,5163,2611,2552,138.9023406
30,196,89.08,17462,8204,9258,196.026044
30,197,112.77,11357,5580,5777,100.7094085
30,198,263.02,6784,3262,3522,25.79271538
30,199,21.7,10720,5190,5530,494.0092166
30,200,178.66,12379,6205,6174,69.28803314
30,201,280.09,41923,20699,21224,149.6768896
30,202,242.27,13866,6868,6998,57.23366492
30,203,68.84,13434,6599,6835,195.1481697
30,204,372.03,46010,22329,23681,123.6728221
30,205,391.73,19128,9512,9616,48.82955097
30,206,30.23,27094,12978,14116,896.2619914
30,207,548.11,45095,21938,23157,82.27363121
30,208,245.78,22907,10921,11986,93.20123688
30,209,295.83,14297,7061,7236,48.32843187
30,210,1912.26,27346,13681,13665,14.30035665
30,211,291.84,29277,14219,15058,100.3186678
30,212,397.37,12409,5986,6423,31.22782294
32,1,292.94,6314,3067,3247,21.55390182
32,2,202.72,5005,2347,2658,24.68922652
32,3,280.98,2692,1287,1405,9.580753079
32,4,328.26,4372,2221,2151,13.31871078
32,5,388.53,39917,19726,20191,102.7385273
32,6,449.18,8239,4039,4200,18.34231266
32,7,2583.98,12803,6448,6355,4.954759712
32,8,323.51,11915,5818,6097,36.83039164
32,9,899.59,10565,5103,5462,11.74423904
32,10,5092.92,213139,104348,108791,41.85005851
32,11,307.7,3013,1472,1541,9.7920052
32,12,796.57,8104,3984,4120,10.17361939
32,13,196.71,5894,2905,2989,29.96288953
32,14,5024.72,21974,10568,11406,4.373179003
32,15,354.83,1609,795,814,4.534565848
32,16,463.97,22346,10976,11370,48.16259672
32,17,773.31,159991,77843,82148,206.8911562
32,18,372.14,4306,2096,2210,11.57091417
32,19,717.64,23557,11380,12177,32.82565074
32,20,1541.75,57610,27792,29818,37.36662883
32,21,1199.58,4584,2238,2346,3.821337468
32,22,625.61,20543,9947,10596,32.83675133
32,23,338.54,12284,5863,6421,36.28522479
32,24,429.37,48365,23746,24619,112.6417775
32,25,177.48,12234,6075,6159,68.93171062
32,26,12138.6,17813,9331,8482,1.467467418
32,27,1979.12,2662,1414,1248,1.345042241
32,28,486.89,2584,1219,1365,5.307153567
32,29,1105.48,22296,10853,11443,20.16861454
32,30,161.45,2529,1216,1313,15.66429235
32,31,1610.86,8929,4352,4577,5.543001875
32,32,181.24,11493,5690,5803,63.41315383
32,33,540.72,4563,2155,2408,8.438748336
32,34,877.05,27932,13157,14775,31.84767117
32,35,408.33,15607,7663,7944,38.2215365
32,36,643.52,40740,19749,20991,63.30805569
32,37,588.28,16875,8407,8468,28.68531992
32,38,3167.73,69844,33973,35871,22.04859631
32,39,1839.28,62693,30198,32495,34.08562046
32,40,1411.92,21533,10433,11100,15.25086407
32,41,653.8,2710,1378,1332,4.14499847
32,42,3607.58,61188,30159,31029,16.96095443
32,43,200.84,1360,636,724,6.77155945
32,44,406.63,15656,7603,8053,38.50183213
32,45,544.71,8215,3934,4281,15.08141947
32,46,724.01,7090,3401,3689,9.792682422
32,47,676.38,5506,2656,2850,8.140394453
32,48,746.45,25493,12470,13023,34.15232099
32,49,5714.16,33323,16349,16974,5.831653296
32,50,161.42,9353,4561,4792,57.94201462
32,51,6554.04,34328,17164,17164,5.237685458
32,52,341.81,18269,9035,9234,53.44782189
32,53,416.35,12893,6177,6716,30.96673472
32,54,365.76,18490,9120,9370,50.55227472
32,55,2179.5,29395,14303,15092,13.48703831
32,56,442.17,138176,66297,71879,312.4951942
32,57,220.95,16934,8358,8576,76.64177416
32,58,279.77,2821,1402,1419,10.0832827
